NO ../texture/nort.png
SO ../texture/south.png
WE ../texture/west.png
EA ../texture/east.png
C 253,201,169
F 255,0,0



111111111
1011000001
1000N0111
10100001
11111111


