NO ../texture/nort.png

C 253,201,169
SO ../texture/south.png
WE ../texture/west.png
F 220,100,30
EA ../texture/east.png


        11111            11111111
        100001          100000001
        1000001111111111000000001
        11000000000000000000000001
         11000000000000000000000001
          110000000000W0000000000001
           11000000000000000000000001
            11000000000000000000000001
             11000000000000000000000001
              1000000000000000000000001
              1000000000000000000000001
             1000000000000000000000001
            1000000000000000000000001
           1000000000000000000000001
          1000000000000000000000001
         1000000000000000000000001        
        1000000000000000000000001
        1111111111111111111111111