NO ../texture/nort.png
SO ../texture/south.png
WE ../texture/west.png
EA ../texture/east.png
C 253,201,169
F 220,100,30

111111
1000W1
111111
