NO ../texture/red_brick_2.png
SO ../texture/red_brick_3.png




WE ../texture/red_brick_4.png
EA ../texture/red_brick_1.png






F 80,80,80
C 30,50,40



        1111111111111111111111111
        100000000011000000000000111111111111111111111111111111111111111111111
        101100000111000000000000000000000000000000000000000000000000000000001
        1001E0000000000000000000111111111011111111111111011111111111111111101
111111111011000001110000000000001       101            101                101
100000000011000001110111111111111       101            101                101
111101111111110111000000100011111       101            101                101
    11110111111111011101010010001       101            101                101
    11000000110101011100000000001       101            101                101
    10000000000000001100000010001       101            101                101
    10000000000000001101010010001       101111111      101                101
    1100000111010101111101111000111     100000001      101                1011
    11110111 1110101 101111010001       100000001      1011111111111111111101
    11111111 1111111 111111111111       111111111      10000000000000000000011
                                           111         1111111111111111111111