NO ../texture/nort.png
SO ../texture/south.png




WE ../texture/west.png
EA ../texture/east.png




F 220,100,0
C 225,30,0


111111111
1N1  1001
111  1111