NO ../texture/nort.png
SO ../texture/south.png
WE ../texture/west.png
EA ../texture/east.png


F 20,100,85
C 5,194,54

111
101
101
1011111111111111111111111111111111111111111111111111111111111111111111111111
1000000000000000000000000000000000011111111111111111111111111111111111111111
1111111111111111111111111111111111010000000000000000000000000000000000000001
1000000000000000000000000000000011010111111111111111111111111111111111111101
1011111111111111111111111111111011010100000000000000000000000000000000000101
1010000000000000000000000000000011010111111111111111111111111111111111100101
1010111111111111111111111111111111010100000000000000000000000000000000100101
1010100000000000000000000000000000010111111111111111111111111111111110100101
1010101111111111111111111111111111110100000000000000000000000000000010100101
1010100000000000000000000000000000000100000000000000000000000000000010100101
1010111111111111111111111111111111110101111111111111111111111111111010100101
1010000000000000000000000000000000000100000000000000000000000000000010100101
1011111111111111111111111111111111110111111111111111111111111111111110100101
1000000000000000000000000000000000000000000000000000000000000000000000100101
1111111111111111111111111111111111111111111111111111111111111111111110100101
1010000000000000000000000000000000000000000000000000000000000000000000100101
1010111111111111111111111111111111111111111111111111111111111111111111100101
1010100000000000000000000000000000000000000000000000000000000000000000000101
1010101111111111111111111111111111111111111111111111111111111111111111111101
1010100000000000000000000000000000000000000000000000000000000000000000000001
1010111111111111111111111111111111111111111111111111111111111111111111111101
1010000000000000000000000000000000000000000000000000000000000000000000000101
1011111111111111111111111111111111111111111111111111111111111111111111110101
1000000000000000000000000000000000000000000000000000000000000000000000000101
1111111111111111111111111111111111111111111111111111111111111111111111100101
1000000000000000000000000000000000000000000000000000000000000000000000000101
1011111111111111111111111111111111111111111111111111111111111111111111111101
1010000000000000000000000000000000000000000000000000000000000000000000000001
1010111111111111111111111111111111111111111111111111111111111111111111111101
1010100000000000000000000000000000000000000000000000000000000000000000000101
1010101111111111111111111111111111111111111111111111111111111111111111111101
1010100000000000000000000000000000000000000000000000000000000000000000000001
1010111111111111111111111111111111111111111111111111111111111111111111111101
1000000000000000000000000000000000000000000000000000000000000000000000000101
1111111111111111111111111111111110111111111111111111111111111111111111100101
1000000000000000000000000000000000110000000000000000000000000000000000000101
1011111111111111111111111111111111110111111111111111111111111111111111111101
1010000000000000000000000000000000010000000000000000000000000000000000000101
1010111111111111111111111111111111011111111111111111111111111111111111111101
1010100000000000000000000000000011010000000000000000000000000000000000000001
1010101111111111111111111111111011010111111111111111111111111111111111111101
1010100000000000000000000000000011010100000000000000000000000000000000000101
10101111111111111111111111111111110101111111111111111111111111111111111111011111
100000000000000000000000000000000000000000000000000000000000000000000000000000E1
11111111111111111111111111111111111111111111111111111111111111111111111111111111